45
45
#############################################
#############################################
#############################################
#########...############################..###
######.......####...############....###....##
#####.........##.....##########............##
###..................#########.............##
##..............mmmm.#########.............##
##.............mmwwmm#########.............##
##.............mwwwwm.#######..............##
##............mmw~~wm...####...............##
##...........mmww~~wm....###...............##
###..........mww~~~wm....####..............##
####.........mw~~~~wm...######............###
#######..##..mw~~~~wm..#######............###
############.mw~~~~wm..#######.............##
############..mw~~wwm..#######.........mmmm##
############...mwwwmm...######........mmwwm##
###########.....mmmm....#######.......mwwww##
###########.............#########......mwww##
##########...............#########.mmmm.mwm##
#########.................#########mwwm..mm##
########..................#########mwwm....##
########...................#######..mmm....##
#########...................#####..........##
###..####...................#####..........##
##....##....................######.........##
##...........................######.........#
##............................#####.........#
###............................####.........#
#####..........................####.........#
######..........................##.........##
######....................................###
#####.....................................###
####......................................###
###................mmmm...................###
###................mwwmm...................##
##................mmwwwm...................##
##..............mmmww~wmm..................##
##.............mmwww~~wwm..................##
###............mww~~~~~wm..................##
####...........mww~~~~~wm..................##
#####...........mmww~~wwm.................###
#######.........###mw~wmm...........#########
#############################################
