40
40
########################################
#........##........##...##...##........#
#........##........##...##...##........#
#........##........##...##...##........#
#........##........##...##...##........#
#........##........##...##...##........#
#........##........##...##...##........#
#........##........##...##...##........#
#........##........##...##...##........#
#........##........##...##...##........#
#........##........##...##...##........#
#........##........##...##...##........#
#........##........##...##...##........#
#........##........##...##...##........#
#........##........##...##...##........#
#........##........##...##...##........#
#........##........##...##...##........#
#........##........##...##...##........#
#........##........##...##...##........#
#####################...##...###########
#####################...##...###########
#........##........##...##...##........#
#........##........##...##...##........#
#........##........##...##...##........#
#........##........##...##...##........#
#........##........##...##...##........#
#........##........##...##...##........#
#........##........##...##...##........#
#........##........##...##...##........#
#........##........##...##...##........#
#........##........##...##...##........#
#........##........##...##...##........#
#........##........##...##...##........#
#........##........##...##...##........#
#........##........##...##...##........#
#........##........##...##...##........#
#........##........##...##...##........#
#........##........##...##...##........#
#........##........##...##...##........#
########################################
