40
21
1111111111111111111111111111111111111111
1000000000000000000000000000000000000001
1000011000000000000000000000000000000001
1000011100000000000000000000000000000001
1000001100000000000000000000000000000001
1000000000000000000000000000000000000001
1000001000000000000000000000000000000001
1000001111111001111111110000000000000001
1000001000000000000000100000000000000001
1000001000000000000111111100000000000001
1000001000000000000000000000000000000001
1000001000000000000000000000000000000001
1000001000000000000000000000000000000101
1000000000000000000000001111110001100101
1000000000000000111100000000010001100101
1000000000000000100100000000010011110111
1000000000000000111100000000010000010001
1000000000000000000000000000011111111101
1000000000000000000000000000010000000001
1000000000000000000000000000000000000001
1111111111111111111111111111111111111111


